##Cooked.txt was origin from team RTLC, zh-tw translate by Voc-夜芷冰

Cooked Bing Bong=熟透的賓邦
Well-done Bing Bong=烤得好的賓邦
Burnt Bing Bong=燒焦的賓邦
Incinerated Bing Bong=炭化的賓邦
Cooked Conch=熟透的貝殼
Well-done Conch=烤得好的貝殼
Burnt Conch=燒焦的貝殼
Incinerated Conch=炭化的貝殼
Cooked Backpack=熟透的背包
Well-done Backpack=烤得好的背包
Burnt Backpack=燒焦的背包
Incinerated Backpack=炭化的背包
Cooked Granola Bar=熟透的燕麥棒
Well-done Granola Bar=烤得好的燕麥棒
Burnt Granola Bar=燒焦的燕麥棒
Incinerated Granola Bar=炭化的燕麥棒
Cooked Trail Mix=熟透的雜錦果乾
Well-done Trail Mix=烤得好的雜錦果乾
Burnt Trail Mix=燒焦的雜錦果乾
Incinerated Trail Mix=炭化的雜錦果乾
Cooked Lantern=熟透的燈籠
Well-done Lantern=烤得好的燈籠
Burnt Lantern=燒焦的燈籠
Incinerated Lantern=炭化的燈籠
Cooked Bugle=熟透的號角
Well-done Bugle=烤得好的號角
Burnt Bugle=燒焦的號角
Incinerated Bugle=炭化的號角
Cooked Compass=熟透的指南針
Well-done Compass=烤得好的指南針
Burnt Compass=燒焦的指南針
Incinerated Compass=炭化的指南針
Cooked Coconut=熟透的椰子
Well-done Coconut=烤得好的椰子
Burnt Coconut=燒焦的椰子
Incinerated Coconut=炭化的椰子
Cooked Coconut Half=熟透的半個椰子
Well-done Coconut Half=烤得好的半個椰子
Burnt Coconut Half=燒焦的半個椰子
Incinerated Coconut Half=炭化的半個椰子
Cooked anti-rope spool=熟透的抗繩卷
Well-done anti-rope spool=烤得好的抗繩卷
Burnt anti-rope spool=燒焦的抗繩卷
Incinerated anti-rope spool=炭化的抗繩卷
Cooked rope spool=熟透的繩卷
Well-done rope spool=烤得好的繩卷
Burnt rope spool=燒焦的繩卷
Incinerated rope spool=炭化的繩卷
Cooked Energy Drink=熟透的能量飲料
Well-done Energy Drink=烤得好的能量飲料
Burnt Energy Drink=燒焦的能量飲料
Incinerated Energy Drink=炭化的能量飲料
Cooked First Aid Kit=熟透的急救包
Well-done First Aid Kit=烤得好的急救包
Burnt First Aid Kit=燒焦的急救包
Incinerated First Aid Kit=炭化的急救包
Cooked Bandages=熟透的繃帶
Well-done Bandages=烤得好的繃帶
Burnt Bandages=燒焦的繃帶
Incinerated Bandages=炭化的繃帶
Cooked Bugle Shroom=熟透的號角菇
Well-done Bugle Shroom=烤得好的號角菇
Burnt Bugle Shroom=燒焦的號角菇
Incinerated Bugle Shroom=炭化的號角菇
Cooked Cluster Shroom=熟透的叢生菇
Well-done Cluster Shroom=烤得好的叢生菇
Burnt Cluster Shroom=燒焦的叢生菇
Incinerated Cluster Shroom=炭化的叢生菇
Cooked Button Shroom=熟透的紐扣菇
Well-done Button Shroom=烤得好的紐扣菇
Burnt Button Shroom=燒焦的紐扣菇
Incinerated Button Shroom=炭化的紐扣菇
Cooked Chubby Shroom=熟透的胖菇
Well-done Chubby Shroom=烤得好的胖菇
Burnt Chubby Shroom=燒焦的胖菇
Incinerated Chubby Shroom=炭化的胖菇
Cooked Weird Shroom=熟透的怪菇
Well-done Weird Shroom=烤得好的怪菇
Burnt Weird Shroom=燒焦的怪菇
Incinerated Weird Shroom=炭化的怪菇
Cooked Airline Food=熟透的航空餐
Well-done Airline Food=烤得好的航空餐
Burnt Airline Food=燒焦的航空餐
Incinerated Airline Food=炭化的航空餐
Cooked Big Lollipop=熟透的大棒棒糖
Well-done Big Lollipop=烤得好的大棒棒糖
Burnt Big Lollipop=燒焦的大棒棒糖
Incinerated Big Lollipop=炭化的大棒棒糖
Cooked Marshmallow=熟透的棉花糖
Well-done Marshmallow=烤得好的棉花糖
Burnt Marshmallow=燒焦的棉花糖
Incinerated Marshmallow=炭化的棉花糖
Cooked Faerie Lantern=熟透的仙女燈籠
Well-done Faerie Lantern=烤得好的仙女燈籠
Burnt Faerie Lantern=燒焦的仙女燈籠
Incinerated Faerie Lantern=炭化的仙女燈籠
Cooked Medicinal Root=熟透的藥用根
Well-done Medicinal Root=烤得好的藥用根
Burnt Medicinal Root=燒焦的藥用根
Incinerated Medicinal Root=炭化的藥用根
Cooked Pirate's Compass=熟透的海盜指南針
Well-done Pirate's Compass=烤得好的海盜指南針
Burnt Pirate's Compass=燒焦的海盜指南針
Incinerated Pirate's Compass=炭化的海盜指南針
Cooked piton=熟透的岩釘
Well-done piton=烤得好的岩釘
Burnt piton=燒焦的岩釘
Incinerated piton=炭化的岩釘
Cooked Scout Cookies=熟透的童軍餅乾
Well-done Scout Cookies=烤得好的童軍餅乾
Burnt Scout Cookies=燒焦的童軍餅乾
Incinerated Scout Cookies=炭化的童軍餅乾
Cooked Sports Drink=熟透的運動飲料
Well-done Sports Drink=烤得好的運動飲料
Burnt Sports Drink=燒焦的運動飲料
Incinerated Sports Drink=炭化的運動飲料
Cooked rope cannon=熟透的繩炮
Well-done rope cannon=烤得好的繩炮
Burnt rope cannon=燒焦的繩炮
Incinerated rope cannon=炭化的繩炮
Cooked anti-rope cannon=熟透的抗繩炮
Well-done anti-rope cannon=烤得好的抗繩炮
Burnt anti-rope cannon=燒焦的抗繩炮
Incinerated anti-rope cannon=炭化的抗繩炮
Cooked Blowgun=熟透的吹箭管
Well-done Blowgun=烤得好的吹箭管
Burnt Blowgun=燒焦的吹箭管
Incinerated Blowgun=炭化的吹箭管
Cooked Chain Launcher=熟透的鏈條發射器
Well-done Chain Launcher=烤得好的鏈條發射器
Burnt Chain Launcher=燒焦的鏈條發射器
Incinerated Chain Launcher=炭化的鏈條發射器
Cooked Tick=熟透的蜱蟲
Well-done Tick=烤得好的蜱蟲
Burnt Tick=燒焦的蜱蟲
Incinerated Tick=炭化的蜱蟲
Cooked Heat Pack=熟透的熱敷包
Well-done Heat Pack=烤得好的熱敷包
Burnt Heat Pack=燒焦的熱敷包
Incinerated Heat Pack=炭化的熱敷包
Cooked Big Egg=熟透的大蛋
Well-done Big Egg=烤得好的大蛋
Burnt Big Egg=燒焦的大蛋
Incinerated Big Egg=炭化的大蛋
Cooked Egg=熟透的蛋
Well-done Egg=烤得好的蛋
Burnt Egg=燒焦的蛋
Incinerated Egg=炭化的蛋
Cooked Beehive=熟透的蜂巢
Well-done Beehive=烤得好的蜂巢
Burnt Beehive=燒焦的蜂巢
Incinerated Beehive=炭化的蜂巢
Cooked Honeycomb=熟透的蜂蜜巢
Well-done Honeycomb=烤得好的蜂蜜巢
Burnt Honeycomb=燒焦的蜂蜜巢
Incinerated Honeycomb=炭化的蜂蜜巢
Cooked Shelf Fungus=熟透的架上真菌
Well-done Shelf Fungus=烤得好的架上真菌
Burnt Shelf Fungus=燒焦的架上真菌
Incinerated Shelf Fungus=炭化的架上真菌
Cooked Remedy Fungus=熟透的治療真菌
Well-done Remedy Fungus=烤得好的治療真菌
Burnt Remedy Fungus=燒焦的治療真菌
Incinerated Remedy Fungus=炭化的治療真菌
Cooked Bounce Fungus=熟透的彈性真菌
Well-done Bounce Fungus=烤得好的彈性真菌
Burnt Bounce Fungus=燒焦的彈性真菌
Incinerated Bounce Fungus=炭化的彈性真菌
Cooked Cure-All=熟透的萬能藥
Well-done Cure-All=烤得好的萬能藥
Burnt Cure-All=燒焦的萬能藥
Incinerated Cure-All=炭化的萬能藥
Cooked Binoculars=熟透的雙筒望遠鏡
Well-done Binoculars=烤得好的雙筒望遠鏡
Burnt Binoculars=燒焦的雙筒望遠鏡
Incinerated Binoculars=炭化的雙筒望遠鏡
Cooked Turtle Flag=熟透的烏龜旗
Well-done Turtle Flag=烤得好的烏龜旗
Burnt Turtle Flag=燒焦的烏龜旗
Incinerated Turtle Flag=炭化的烏龜旗
Cooked Cursed Skull=熟透的詛咒頭骨
Well-done Cursed Skull=烤得好的詛咒頭骨
Burnt Cursed Skull=燒焦的詛咒頭骨
Incinerated Cursed Skull=炭化的詛咒頭骨
Cooked Pandora's Lunchbox=熟透的潘朵拉午餐盒
Well-done Pandora's Lunchbox=烤得好的潘朵拉午餐盒
Burnt Pandora's Lunchbox=燒焦的潘朵拉午餐盒
Incinerated Pandora's Lunchbox=炭化的潘朵拉午餐盒
Cooked Scout Effigy=熟透的童軍雕像
Well-done Scout Effigy=烤得好的童軍雕像
Burnt Scout Effigy=燒焦的童軍雕像
Incinerated Scout Effigy=炭化的童軍雕像
Cooked Scoutmaster's Bugle=熟透的童軍領袖號角
Well-done Scoutmaster's Bugle=烤得好的童軍領袖號角
Burnt Scoutmaster's Bugle=燒焦的童軍領袖號角
Incinerated Scoutmaster's Bugle=炭化的童軍領袖號角
Cooked Warp Compass=熟透的傳送指南針
Well-done Warp Compass=烤得好的傳送指南針
Burnt Warp Compass=燒焦的傳送指南針
Incinerated Warp Compass=炭化的傳送指南針
Cooked Scroll=熟透的卷軸
Well-done Scroll=烤得好的卷軸
Burnt Scroll=燒焦的卷軸
Incinerated Scroll=炭化的卷軸
Cooked Stick=熟透的木棒
Well-done Stick=烤得好的木棒
Burnt Stick=燒焦的木棒
Incinerated Stick=炭化的木棒
Cooked Stone=熟透的石頭
Well-done Stone=烤得好的石頭
Burnt Stone=燒焦的石頭
Incinerated Stone=炭化的石頭
Cooked Megaphone=熟透的擴音器
Well-done Megaphone=烤得好的擴音器
Burnt Megaphone=燒焦的擴音器
Incinerated Megaphone=炭化的擴音器
Cooked Green Crispberry=熟透的綠色脆莓
Cooked Red Crispberry=熟透的紅色脆莓
Cooked Yellow Crispberry=熟透的黃色脆莓
Cooked Purple Crispberry=熟透的紫色脆莓
Cooked Black Crispberry=熟透的黑色脆莓
Cooked Blue Crispberry=熟透的藍色脆莓
Cooked Pink Crispberry=熟透的粉紅色脆莓
Cooked Brown Crispberry=熟透的棕色脆莓
Cooked Orange Crispberry=熟透的橙色脆莓
Cooked Green Kingberry=熟透的綠色王莓
Cooked Red Kingberry=熟透的紅色王莓
Cooked Yellow Kingberry=熟透的黃色王莓
Cooked Purple Kingberry=熟透的紫色王莓
Cooked Black Kingberry=熟透的黑色王莓
Cooked Blue Kingberry=熟透的藍色王莓
Cooked Pink Kingberry=熟透的粉紅色王莓
Cooked Brown Kingberry=熟透的棕色王莓
Cooked Orange Kingberry=熟透的橙色王莓
Cooked Green Clusterberry=熟透的綠色叢莓
Cooked Red Clusterberry=熟透的紅色叢莓
Cooked Yellow Clusterberry=熟透的黃色叢莓
Cooked Purple Clusterberry=熟透的紫色叢莓
Cooked Black Clusterberry=熟透的黑色叢莓
Cooked Blue Clusterberry=熟透的藍色叢莓
Cooked Pink Clusterberry=熟透的粉紅色叢莓
Cooked Brown Clusterberry=熟透的棕色叢莓
Cooked Orange Clusterberry=熟透的橙色叢莓
Cooked Green Winterberry=熟透的綠色冬莓
Cooked Red Winterberry=熟透的紅色冬莓
Cooked Yellow Winterberry=熟透的黃色冬莓
Cooked Purple Winterberry=熟透的紫色冬莓
Cooked Black Winterberry=熟透的黑色冬莓
Cooked Blue Winterberry=熟透的藍色冬莓
Cooked Pink Winterberry=熟透的粉紅色冬莓
Cooked Brown Winterberry=熟透的棕色冬莓
Cooked Orange Winterberry=熟透的橙色冬莓
Cooked Green Berrynana=熟透的綠色莓蕉
Cooked Red Berrynana=熟透的紅色莓蕉
Cooked Yellow Berrynana=熟透的黃色莓蕉
Cooked Purple Berrynana=熟透的紫色莓蕉
Cooked Black Berrynana=熟透的黑色莓蕉
Cooked Blue Berrynana=熟透的藍色莓蕉
Cooked Pink Berrynana=熟透的粉紅色莓蕉
Cooked Brown Berrynana=熟透的棕色莓蕉
Cooked Orange Berrynana=熟透的橙色莓蕉
Well-done Green Crispberry=烤得好的綠色脆莓
Well-done Red Crispberry=烤得好的紅色脆莓
Well-done Yellow Crispberry=烤得好的黃色脆莓
Well-done Purple Crispberry=烤得好的紫色脆莓
Well-done Black Crispberry=烤得好的黑色脆莓
Well-done Blue Crispberry=烤得好的藍色脆莓
Well-done Pink Crispberry=烤得好的粉紅色脆莓
Well-done Brown Crispberry=烤得好的棕色脆莓
Well-done Orange Crispberry=烤得好的橙色脆莓
Well-done Green Kingberry=烤得好的綠色王莓
Well-done Red Kingberry=烤得好的紅色王莓
Well-done Yellow Kingberry=烤得好的黃色王莓
Well-done Purple Kingberry=烤得好的紫色王莓
Well-done Black Kingberry=烤得好的黑色王莓
Well-done Blue Kingberry=烤得好的藍色王莓
Well-done Pink Kingberry=烤得好的粉紅色王莓
Well-done Brown Kingberry=烤得好的棕色王莓
Well-done Orange Kingberry=烤得好的橙色王莓
Well-done Green Clusterberry=烤得好的綠色叢莓
Well-done Red Clusterberry=烤得好的紅色叢莓
Well-done Yellow Clusterberry=烤得好的黃色叢莓
Well-done Purple Clusterberry=烤得好的紫色叢莓
Well-done Black Clusterberry=烤得好的黑色叢莓
Well-done Blue Clusterberry=烤得好的藍色叢莓
Well-done Pink Clusterberry=烤得好的粉紅色叢莓
Well-done Brown Clusterberry=烤得好的棕色叢莓
Well-done Orange Clusterberry=烤得好的橙色叢莓
Well-done Green Winterberry=烤得好的綠色冬莓
Well-done Red Winterberry=烤得好的紅色冬莓
Well-done Yellow Winterberry=烤得好的黃色冬莓
Well-done Purple Winterberry=烤得好的紫色冬莓
Well-done Black Winterberry=烤得好的黑色冬莓
Well-done Blue Winterberry=烤得好的藍色冬莓
Well-done Pink Winterberry=烤得好的粉紅色冬莓
Well-done Brown Winterberry=烤得好的棕色冬莓
Well-done Orange Winterberry=烤得好的橙色冬莓
Well-done Green Berrynana=烤得好的綠色莓蕉
Well-done Red Berrynana=烤得好的紅色莓蕉
Well-done Yellow Berrynana=烤得好的黃色莓蕉
Well-done Purple Berrynana=烤得好的紫色莓蕉
Well-done Black Berrynana=烤得好的黑色莓蕉
Well-done Blue Berrynana=烤得好的藍色莓蕉
Well-done Pink Berrynana=烤得好的粉紅色莓蕉
Well-done Brown Berrynana=烤得好的棕色莓蕉
Well-done Orange Berrynana=烤得好的橙色莓蕉
Burnt Green Crispberry=燒焦的綠色脆莓
Burnt Red Crispberry=燒焦的紅色脆莓
Burnt Yellow Crispberry=燒焦的黃色脆莓
Burnt Purple Crispberry=燒焦的紫色脆莓
Burnt Black Crispberry=燒焦的黑色脆莓
Burnt Blue Crispberry=燒焦的藍色脆莓
Burnt Pink Crispberry=燒焦的粉紅色脆莓
Burnt Brown Crispberry=燒焦的棕色脆莓
Burnt Orange Crispberry=燒焦的橙色脆莓
Burnt Green Kingberry=燒焦的綠色王莓
Burnt Red Kingberry=燒焦的紅色王莓
Burnt Yellow Kingberry=燒焦的黃色王莓
Burnt Purple Kingberry=燒焦的紫色王莓
Burnt Black Kingberry=燒焦的黑色王莓
Burnt Blue Kingberry=燒焦的藍色王莓
Burnt Pink Kingberry=燒焦的粉紅色王莓
Burnt Brown Kingberry=燒焦的棕色王莓
Burnt Orange Kingberry=燒焦的橙色王莓
Burnt Green Clusterberry=燒焦的綠色叢莓
Burnt Red Clusterberry=燒焦的紅色叢莓
Burnt Yellow Clusterberry=燒焦的黃色叢莓
Burnt Purple Clusterberry=燒焦的紫色叢莓
Burnt Black Clusterberry=燒焦的黑色叢莓
Burnt Blue Clusterberry=燒焦的藍色叢莓
Burnt Pink Clusterberry=燒焦的粉紅色叢莓
Burnt Brown Clusterberry=燒焦的棕色叢莓
Burnt Orange Clusterberry=燒焦的橙色叢莓
Burnt Green Winterberry=燒焦的綠色冬莓
Burnt Red Winterberry=燒焦的紅色冬莓
Burnt Yellow Winterberry=燒焦的黃色冬莓
Burnt Purple Winterberry=燒焦的紫色冬莓
Burnt Black Winterberry=燒焦的黑色冬莓
Burnt Blue Winterberry=燒焦的藍色冬莓
Burnt Pink Winterberry=燒焦的粉紅色冬莓
Burnt Brown Winterberry=燒焦的棕色冬莓
Burnt Orange Winterberry=燒焦的橙色冬莓
Burnt Green Berrynana=燒焦的綠色莓蕉
Burnt Red Berrynana=燒焦的紅色莓蕉
Burnt Yellow Berrynana=燒焦的黃色莓蕉
Burnt Purple Berrynana=燒焦的紫色莓蕉
Burnt Black Berrynana=燒焦的黑色莓蕉
Burnt Blue Berrynana=燒焦的藍色莓蕉
Burnt Pink Berrynana=燒焦的粉紅色莓蕉
Burnt Brown Berrynana=燒焦的棕色莓蕉
Burnt Orange Berrynana=燒焦的橙色莓蕉
Incinerated Green Crispberry=炭化的綠色脆莓
Incinerated Red Crispberry=炭化的紅色脆莓
Incinerated Yellow Crispberry=炭化的黃色脆莓
Incinerated Purple Crispberry=炭化的紫色脆莓
Incinerated Black Crispberry=炭化的黑色脆莓
Incinerated Blue Crispberry=炭化的藍色脆莓
Incinerated Pink Crispberry=炭化的粉紅色脆莓
Incinerated Brown Crispberry=炭化的棕色脆莓
Incinerated Orange Crispberry=炭化的橙色脆莓
Incinerated Green Kingberry=炭化的綠色王莓
Incinerated Red Kingberry=炭化的紅色王莓
Incinerated Yellow Kingberry=炭化的黃色王莓
Incinerated Purple Kingberry=炭化的紫色王莓
Incinerated Black Kingberry=炭化的黑色王莓
Incinerated Blue Kingberry=炭化的藍色王莓
Incinerated Pink Kingberry=炭化的粉紅色王莓
Incinerated Brown Kingberry=炭化的棕色王莓
Incinerated Orange Kingberry=炭化的橙色王莓
Incinerated Green Clusterberry=炭化的綠色叢莓
Incinerated Red Clusterberry=炭化的紅色叢莓
Incinerated Yellow Clusterberry=炭化的黃色叢莓
Incinerated Purple Clusterberry=炭化的紫色叢莓
Incinerated Black Clusterberry=炭化的黑色叢莓
Incinerated Blue Clusterberry=炭化的藍色叢莓
Incinerated Pink Clusterberry=炭化的粉紅色叢莓
Incinerated Brown Clusterberry=炭化的棕色叢莓
Incinerated Orange Clusterberry=炭化的橙色叢莓
Incinerated Green Winterberry=炭化的綠色冬莓
Incinerated Red Winterberry=炭化的紅色冬莓
Incinerated Yellow Winterberry=炭化的黃色冬莓
Incinerated Purple Winterberry=炭化的紫色冬莓
Incinerated Black Winterberry=炭化的黑色冬莓
Incinerated Blue Winterberry=炭化的藍色冬莓
Incinerated Pink Winterberry=炭化的粉紅色冬莓
Incinerated Brown Winterberry=炭化的棕色冬莓
Incinerated Orange Winterberry=炭化的橙色冬莓
Incinerated Green Berrynana=炭化的綠色莓蕉
Incinerated Red Berrynana=炭化的紅色莓蕉
Incinerated Yellow Berrynana=炭化的黃色莓蕉
Incinerated Purple Berrynana=炭化的紫色莓蕉
Incinerated Black Berrynana=炭化的黑色莓蕉
Incinerated Blue Berrynana=炭化的藍色莓蕉
Incinerated Pink Berrynana=炭化的粉紅色莓蕉
Incinerated Brown Berrynana=炭化的棕色莓蕉
Incinerated Orange Berrynana=炭化的橙色莓蕉
Cooked Berrynana Peel=熟透的莓蕉皮
Well-done Berrynana Peel=烤得好的莓蕉皮
Burnt Berrynana Peel=燒焦的莓蕉皮
Incinerated Berrynana Peel=炭化的莓蕉皮
Cooked Scorchberry=熟透的灼莓
Well-done Scorchberry=烤得好的灼莓
Burnt Scorchberry=燒焦的灼莓
Incinerated Scorchberry=炭化的灼莓
Cooked Napberry=熟透的眠莓
Well-done Napberry=烤得好的眠莓
Burnt Napberry=燒焦的眠莓
Incinerated Napberry=炭化的眠莓
Cooked Antidote=熟透的解毒劑
Well-done Antidote=烤得好的解毒劑
Burnt Antidote=燒焦的解毒劑
Incinerated Antidote=炭化的解毒劑
Cooked Bugle of Friendship=熟透的友誼號角
Well-done Bugle of Friendship=烤得好的友誼號角
Burnt Bugle of Friendship=燒焦的友誼號角
Incinerated Bugle of Friendship=炭化的友誼號角
Cooked Portable Stove=熟透的便攜式爐具
Well-done Portable Stove=烤得好的便攜式爐具
Burnt Portable Stove=燒焦的便攜式爐具
Incinerated Portable Stove=炭化的便攜式爐具
Cooked Guidebook=熟透的指南書
Well-done Guidebook=烤得好的指南書
Burnt Guidebook=燒焦的指南書
Incinerated Guidebook=炭化的指南書
Cooked Flare=熟透的信號彈
Well-done Flare=烤得好的信號彈
Burnt Flare=燒焦的信號彈
Incinerated Flare=炭化的信號彈