ACCOLADES=DANH HIỆU
Scout=HƯỚNG ĐẠO SINH
r:PEAKS SUMMITTED: (\d+)=Số lần chinh phục PEAK: $1
You don't have this badge yet!=Bạn chưa có huy hiệu này!
Have a friend escape the island without you.=Để một người bạn thoát khỏi hòn đảo mà không có bạn.
Escape the island in under an hour.=Thoát khỏi hòn đảo trong vòng chưa đầy một giờ.
Help Bing Bong escape the island.=Giúp Bing Bong thoát khỏi hòn đảo.
Climb past the SHORE.=Leo qua BỜ BIỂN.
Climb past the TROPICS.=Leo qua NHIỆT ĐỚI.
Escape the island without eating any packaged food.=Thoát khỏi hòn đảo mà không ăn bất kỳ thực phẩm đóng gói nào.
Escape the island after cooking and eating a coconut half, a honeycomb, a yellow winterberry, and an egg.=Thoát khỏi hòn đảo sau khi nướng và ăn một nửa quả dừa, một tổ ong, một quả đông vàng và một quả trứng.
Climb past the ALPINE.=Leo qua CỰC LẠNH.
Climb past the CALDERA.=Leo qua VÒNG LỬA.
Eat four different non-toxic mushrooms in a single expedition.=Ăn bốn loại nấm không độc khác nhau trong một cuộc thám hiểm.
Heal your friends for 100 points of injury in a single expedition.=Chữa trị cho bạn bè 100 điểm thương tích trong một cuộc thám hiểm.
Reach the PEAK.=Đạt đỉnh PEAK.
Cook 20 meals at campfires.=Nấu 20 bữa ăn tại lửa trại.
Escape the island without ever losing consciousness.=Thoát khỏi hòn đảo mà không bao giờ bị mất ý thức.
Play the bugle for a capybara.=Chơi kèn cho một con capybara.
Receive 5 Morale Boosts from campfires.=Bùng nổ tinh thần 5 lần từ lửa trại.
Place 10 pitons.=Cắm 10 neo đá.
Reach the top of a really big tree.=Leo lên trên ngọn của một cái cây lớn.
Have a 1-on-1 with the Scoutmaster.=Gạ kèo solo yasuo với Trưởng Hướng Đạo.
Restore 200 total poison by using items.=Hồi phục tổng cộng 200 điểm độc bằng cách dùng vật phẩm.
Eat 5 different berries in a single expedition.=Ăn 5 loại quả mọng khác nhau trong một cuộc thám hiểm.
Place 100m of rope in a single expedition.=Đặt tổng cộng 100m dây trong một cuộc thám hiểm.
Obtain a mystical item.=Nhận được một vật phẩm huyền bí.
Heal an unconscious friend with an item to save them from death.=Chữa trị một người bạn bất tỉnh; ở ngưỡng cửa tử bằng cách dùng vật phẩm.
Climb 5000m total.=Leo tổng cộng 5000m.
Escape the island in a solo expedition.=Thoát khỏi hòn đảo trong một cuộc thám hiểm đơn.
Resurrect 3 scouts in a single expedition.=Hồi sinh 3 người bạn trong một cuộc thám hiểm.
Open 15 luggages in a single expedition.=Mở 15 chiếc vali trong một cuộc thám hiểm.
Escape the island without taking fall damage.=Thoát khỏi hòn đảo mà không bị thương do rơi.
Read all of Scoutmaster Myres's journal entries.=Đọc tất cả các mục nhật ký của Trưởng Hướng Đạo Myres.
Escape the island without placing anything on the mountain.=Thoát khỏi hòn đảo mà không cắm hay đặt bất kỳ vật phẩm nào trên núi.
Climb 50m upwards without touching the ground.=Leo liên tục 50 mét mà không chạm đất.
Beachcomber Badge=Huy Hiệu Người Nhặt Ốc
BEACHCOMBER BADGE=HUY HIỆU NGƯỜI NHẶT ỐC
Trailblazer Badge=Huy Hiệu Nhà Khai Phá
TRAILBLAZER BADGE=HUY HIỆU NHÀ KHAI PHÁ
Alpinist Badge=Huy Hiệu Dãy An-pơ
ALPINIST BADGE=HUY HIỆU DÃY AN-PƠ
Volcanology Badge=Huy Hiệu Núi Lửa Học
VOLCANOLOGY BADGE=HUY HIỆU NÚI LỬA HỌC
Peak Badge=Huy Hiệu Peak
PEAK BADGE=HUY HIỆU PEAK
Participation Badge=Huy Hiệu Tham Gia
PARTICIPATION BADGE=HUY HIỆU THAM GIA
Esoterica Badge=HUY HIỆU HUYỀN BÍ
ESOTERICA BADGE=HUY HIỆU HUYỀN BÍ
Clutch Badge=Huy Hiệu Xuất Thần
CLUTCH BADGE=HUY HIỆU XUẤT THẦN
First Aid Badge=Huy Hiệu Sơ Cứu
FIRST AID BADGE=HUY HIỆU SƠ CỨU
Happy Camper Badge=Huy Hiệu Người Cắm Trại Vui Vẻ
HAPPY CAMPER BADGE=HUY HIỆU NGƯỜI CẮM TRẠI VUI VẺ
Emergency Preparedness Badge=Huy Hiệu Chuẩn Bị Khẩn Cấp
EMERGENCY PREPAREDNESS BADGE=HUY HIỆU CHUẨN BỊ KHẨN CẤP
Plunderer Badge=Huy Hiệu Kẻ Tước Đoạt
PLUNDERER BADGE=HUY HIỆU KẺ TƯỚC ĐOẠT
High Altitude Badge=Huy Hiệu Cao Độ
HIGH ALTITUDE BADGE=HUY HIỆU CAO ĐỘ
Foraging Badge=Huy Hiệu Thu Thập
FORAGING BADGE=HUY HIỆU THU THẬP
Arborist Badge=Huy Hiệu Chăm Cây
ARBORIST BADGE=HUY HIỆU CHĂM CÂY
Endurance Badge=Huy Hiệu Bền Bỉ
ENDURANCE BADGE=HUY HIỆU BỀN BỈ
Mentorship Badge=Huy Hiệu Kèm Cặp
MENTORSHIP BADGE=HUY HIỆU KÈM CẶP
Cooking Badge=Huy Hiệu Nấu Ăn
COOKING BADGE=HUY HIỆU NẤU ĂN
Animal Serenading Badge=Huy Hiệu Dỗ Động Vật
ANIMAL SERENADING BADGE=HUY HIỆU DỖ ĐỘNG VẬT
TOXICOLOGY BADGE=HUY HIỆU ĐỘC TỐ
BOULDERING BADGE=HUY HIỆU CẮM SỪNG
Mycology Badge=Huy Hiệu Nấm Học
MYCOLOGY BADGE=HUY HIỆU NẤM HỌC
Knot Tying Badge=Huy Hiệu Thắt Dây
KNOT TYING BADGE=HUY HIỆU THẮT DÂY
Survivalist Badge=Huy Hiệu Sinh Tồn
SURVIVALIST BADGE=HUY HIỆU SINH TỒN
Bing Bong Badge=Huy Hiệu Bing Bong
BING BONG BADGE=HUY HIỆU BING BONG
Lone Wolf Badge=Huy Hiệu Sói Cô Độc
LONE WOLF BADGE=HUY HIỆU SÓI CÔ ĐỘC
Speed Climber Badge=Huy Hiệu Speedclimber
SPEED CLIMBER BADGE=HUY HIỆU Speedclimber
Balloon Badge=Huy Hiệu Bóng Bay
BALLOON BADGE=HUY HIỆU BÓNG BAY
Naturalist Badge=Huy Hiệu Tự Nhiên
NATURALIST BADGE=HUY HIỆU TỰ NHIÊN
Leave No Trace Badge=Huy Hiệu Không Để Lại Dấu Vết
LEAVE NO TRACE BADGE=HUY HIỆU KHÔNG ĐỂ LẠI DẤU VẾT
Gourmand Badge=Huy Hiệu Phàm Ăn
GOURMAND BADGE=HUY HIỆU PHÀM ĂN
Bookworm Badge=Huy Hiệu Mọt Sách
BOOKWORM BADGE=HUY HIỆU MỌT SÁCH
Tadpole Scout=Hướng Đạo Sinh Nòng Nọc
TADPOLE SCOUT=HƯỚNG ĐẠO SINH NÒNG NỌC
Rabbit Scout=Hướng Đạo Sinh Thỏ
RABBIT SCOUT=HƯỚNG ĐẠO SINH THỎ
Raccoon Scout=Hướng Đạo Sinh Gấu Mèo
RACCOON SCOUT=HƯỚNG ĐẠO SINH GẤU MÈO
Mule Scout=Hướng Đạo Sinh La
MULE SCOUT=HƯỚNG ĐẠO SINH La
Kangaroo Scout=Hướng Đạo Sinh Kangaroo
KANGAROO SCOUT=HƯỚNG ĐẠO SINH KANGAROO
Owl Scout=Hướng Đạo Sinh Cú
OWL SCOUT=HƯỚNG ĐẠO SINH CÚ
Wolf Scout=Hướng Đạo Sinh Sói
WOLF SCOUT=HƯỚNG ĐẠO SINH SÓI
Goat Scout=Hướng Đạo Sinh Dê Huyền Thoại
GOAT SCOUT=HƯỚNG ĐẠO SINH DÊ HUYỀN THOẠI
