THIS GAME USES VOICE CHAT=<size\=90%\>TRÒ CHƠI NÀY CÓ TRÒ CHUYỆN BẰNG GIỌNG NÓI
PLEASE USE HEADPHONES AND A MICROPHONE=XIN HÃY SỬ DỤNG TAI NGHE VÀ MICRO
SELECT MICROPHONE=CHỌN MICRO
CONTINUE=TIẾP TỤC
CONNECTING...=ĐANG KẾT NỐI...
AUTHENTICATING...=ĐANG XÁC THỰC...
L=Đ
LO=ĐA
LOA=ĐAN
LOAD=ĐANG
LOADI=ĐANG T
LOADIN=ĐANG TẢ
LOADING=ĐANG TẢI
LOADING.=ĐANG TẢI.
LOADING..=ĐANG TẢI..
LOADING...=ĐANG TẢI...
LOADING...L=ĐANG TẢI...Đ
LOADING...LO=ĐANG TẢI...ĐA
LOADING...LOA=ĐANG TẢI...ĐAN
LOADING...LOAD=ĐANG TẢI...ĐANG
LOADING...LOADI=ĐANG TẢI...ĐANG T
LOADING...LOADIN=ĐANG TẢI...ĐANG TẢ
LOADING...LOADING=ĐANG TẢI...ĐANG TẢI
LOADING...LOADING.=ĐANG TẢI...ĐANG TẢI.
LOADING...LOADING..=ĐANG TẢI...ĐANG TẢI..
LOADING...LOADING...=ĐANG TẢI...ĐANG TẢI...
LOADING...LOADING...L=ĐANG TẢI...ĐANG TẢI...Đ
LOADING...LOADING...LO=ĐANG TẢI...ĐANG TẢI...ĐA
LOADING...LOADING...LOA=ĐANG TẢI...ĐANG TẢI...ĐAN
LOADING...LOADING...LOAD=ĐANG TẢI...ĐANG TẢI...ĐANG
LOADING...LOADING...LOADI=ĐANG TẢI...ĐANG TẢI...ĐANG T
LOADING...LOADING...LOADIN=ĐANG TẢI...ĐANG TẢI...ĐANG TẢ
LOADING...LOADING...LOADING=ĐANG TẢI...ĐANG TẢI...ĐANG TẢI
LOADING...LOADING...LOADING.=ĐANG TẢI...ĐANG TẢI...ĐANG TẢI.
LOADING...LOADING...LOADING..=ĐANG TẢI...ĐANG TẢI...ĐANG TẢI..
LOADING...LOADING...LOADING...=ĐANG TẢI...ĐANG TẢI...ĐANG TẢI...
LOADING...LOADING...LOADING...L=ĐANG TẢI...ĐANG TẢI...ĐANG TẢI...Đ
LOADING...LOADING...LOADING...LO=ĐANG TẢI...ĐANG TẢI...ĐANG TẢI...ĐA
LOADING...LOADING...LOADING...LOA=ĐANG TẢI...ĐANG TẢI...ĐANG TẢI...ĐAN
LOADING...LOADING...LOADING...LOADI=ĐANG TẢI...ĐANG TẢI...ĐANG TẢI...ĐANG
LOADING...LOADING...LOADING...LOADIN=ĐANG TẢI...ĐANG TẢI...ĐANG TẢI...ĐANG TẢ
LOADING...LOADING...LOADING...LOADING=ĐANG TẢI...ĐANG TẢI...ĐANG TẢI...ĐANG TẢI
LOADING...LOADING...LOADING...LOADING.=ĐANG TẢI...ĐANG TẢI...ĐANG TẢI...ĐANG TẢI.
LOADING...LOADING...LOADING...LOADING..=ĐANG TẢI...ĐANG TẢI...ĐANG TẢI...ĐANG TẢI..
LOADING...LOADING...LOADING...LOADING...=ĐANG TẢI...ĐANG TẢI...ĐANG TẢI...ĐANG TẢI...
D=N
DA=NG
DAY=NGÀY
DAY =NGÀY 
DAY O=NGÀY M
DAY ON=NGÀY MỘ
DAY ONE=NGÀY MỘT
DAY T=NGÀY
DAY TW=NGÀY HA
DAY TWO=NGÀY HAI
DAY TH=NGÀY
DAY THR=NGÀY B
DAY THRE=NGÀY BA
DAY THREE=NGÀY BA
DAY F=NGÀY 
DAY FO=NGÀY B
DAY FOU=NGÀY BỐ
DAY FOUR=NGÀY BỐN
DAY FI=NGÀY N
DAY FIV=NGÀY NĂ
DAY FIVE=NGÀY NĂM
DAY S=NGÀY S
DAY SI=NGÀY SÁ
DAY SIX=NGÀY SÁU
r:"^DAY (\d+)$"=NGÀY $1
D=N
Da=Ng
Day=Ngày
Day =Ngày 
Day O=Ngày M
Day On=Ngày Mộ
Day One=Ngày Một
Day T=Ngày
Day Tw=Ngày Ha
Day Two=Ngày Hai
Day Th=Ngày
Day Thr=Ngày B
Day Thre=Ngày Ba
Day Three=Ngày Ba
Day F=Ngày 
Day Fo=Ngày B
Day Fou=Ngày Bố
Day Four=Ngày Bốn
Day Fi=Ngày N
Day Fiv=Ngày Nă
Day Five=Ngày Năm
Day S=Ngày S
Day Si=Ngày Sá
Day Six=Ngày Sáu
r:"^Day (\d+)$"=Ngày $1
THE FOG RISES...=MÀN SƯƠNG DÂNG CAO...
