GENERAL=CHUNG
BACK=TRỞ LẠI
LANGUAGE=NGÔN NGỮ
FIELD OF VIEW=GÓC NHÌN
MOUSE SENSITIVITY=ĐỘ NHẠY CHUỘT
CONTROLLER SENSITIVITY=ĐỘ NHẠY TAY CẦM
CONTROLLER ICONS=BIỂU TƯỢNG TAY CẦM
AUTO=TỰ ĐỘNG
r:"^STYLE (.+)$"=PHONG CÁCH $1
INVERT Y=ĐẢO TRỤC Y
INVERT X=ĐẢO TRỤC X
OFF=TẮT
ON=BẬT
LOBBY MODE=CHẾ ĐỘ PHÒNG CHỜ
FRIENDS=BẠN BÈ
INVITE ONLY=CHỈ CÓ THỂ MỜI
GRAPHICS=ĐỒ HỌA
WINDOW MODE=CHẾ ĐỘ CỬA SỔ
FULLSCREEN=TOÀN MÀN HÌNH
WINDOWED=CỬA SỔ
WINDOWED FULLSCREEN=CỬA SỔ KHÔNG VIỀN
MAX FRAMERATE=TỐC ĐỘ KHUNG HÌNH TỐI ĐA
VSYNC=VSYNC
NONE=KHÔNG
ENABLED=KÍCH HOẠT
RENDER SCALE=TỶ LỆ HIỂN THỊ
NATIVE=NGUYÊN BẢN
HIGH=CAO
MEDIUM=TRUNG BÌNH
LOW=THẤP
SHADOW DISTANCE=KHOẢNG CÁCH BÓNG
OFF=TẮT
WORLD QUALITY=CHẤT LƯỢNG THẾ GIỚI
AMBIENT OCCLUSION=ĐỔ BÓNG MÔI TRƯỜNG
RESOLUTION=ĐỘ PHÂN GIẢI
AUDIO=ÂM THANH
MICROPHONE=MICRO
MICROPHONE MODE=CHẾ ĐỘ MICRO
VOICE ACTIVATION=LUÔN BẬT
PUSH TO TALK=NHẤN ĐỂ NÓI [V]
MASTER VOLUME=ÂM LƯỢNG CHÍNH
MUSIC VOLUME=ÂM LƯỢNG NHẠC
SFX VOLUME=ÂM LƯỢNG HIỆU ỨNG
VOICES VOLUME=ÂM LƯỢNG GIỌNG NÓI
REDUCE CAMERA BOBBING=GIẢM RUNG CAMERA
